TblAnimal	TblAnimalData
TblAnimalAssessment	TblAnimalAssessmentData
TblAnimalDataBirth	TblAnimalDataBirthData
TblAnimalDataCarcass	TblAnimalDataCarcassData
TblAnimalDataMature	TblAnimalDataMatureData
TblAnimalDataMisc	TblAnimalDataMiscData
TblAnimalDataOtherWeight	TblAnimalDataOtherWeightData
TblAnimalDataUltrasound	TblAnimalDataUltrasoundData
TblAnimalDataWean	TblAnimalDataWeanData
TblAnimalDataYear	TblAnimalDataYearData
TblAnimalHealth	TblAnimalHealthData
TblAnimalHeat	TblAnimalHeatData
TblAnimalNotes	TblAnimalNotesData
TblAnimalPastureLocation	TblAnimalPastureLocationData
TblAnimalPenLocation	TblAnimalPenLocationData
TblAnimalPhoto	TblAnimalPhotoData
TblAnimalSync	TblAnimalSyncData
TblAssociationCodesBodyCondition	TblAssociationCodesBodyConditionData
TblAssociationCodesBreed	TblAssociationCodesBreedData
TblAssociationCodesCalvingEase	TblAssociationCodesCalvingEaseData
TblAssociationCodesColorScore	TblAssociationCodesColorScoreData
TblAssociationCodesDisposal	TblAssociationCodesDisposalData
TblAssociationCodesManagement	TblAssociationCodesManagementData
TblAssociationCodesNavelScore	TblAssociationCodesNavelScoreData
TblAssociationCodesScurScore	TblAssociationCodesScurScoreData
TblAssociationCodesSheathScore	TblAssociationCodesSheathScoreData
TblAssociationCodesTemperScore	TblAssociationCodesTemperScoreData
TblAssociationCodesTwinCode	TblAssociationCodesTwinCodeData
TblAssociationCodesUdderScoreSuspension	TblAssociationCodesUdderScoreSuspensionData
TblAssociationCodesUdderScoreTeatSize	TblAssociationCodesUdderScoreTeatSizeData
TblBreedingAi	TblBreedingAiData
TblBreedingEt	TblBreedingEtData
TblBreedingNs	TblBreedingNsData
TblInventoryEmbryo	TblInventoryEmbryoData
TblInventorySemen	TblInventorySemenData
TblLogs	TblLogsData
TblMemberAndroidReports	TblMemberAndroidReportsData
TblMemberTransfers	TblMemberTransfersData
TblOwnership	TblOwnershipData
TblPastures	TblPasturesData
TblPens	TblPensData
TblReports	TblReportsData
TblTodo	TblTodoData
TblVaccinations	TblVaccinationsData
TblWorkOrder	TblWorkOrderData
TblWorkOrderInvoiceItems	TblWorkOrderInvoiceItemsData
VwCustomers	VwCustomersData
VwEpd	VwEpdData
